00000000000000000000
01111131111111411100
01000001011010011100
01101111101101110010
01101010101011001150
21114111301111011010
01101010111001301100
01101010010110101010
01101111411001011110
01011011111111001010
01111101011311011110
01010101110111011010
01110101111311101111
01100101110001101110
01111101113111101110
01001001010101111100
01111411111111110100
00101001010100000100
00601111113111101100
00000000000000000000
