00000000000000000000
00110000011101011010
00101010100101011000
00111011101101111010
00101010111013001110
21101010001010010110
00101110111011110010
00111010010110001010
01101311111001111110
01000010001111001010
01110110101101101110
00011101010101011010
01110101010131101111
00110101110010101010
01111001011111101000
01000111000001011100
01111001131111110100
00101000010100000100
00111111111111111110
00000000000000000000