00000000000000000000
00111011100101011150
00101010100101011000
00141011101101111010
00101010111013001110
21101010001010010110
00101110111011110010
00111010010110011010
01101311411001111110
01000010001111001010
01410110101101101110
00011101010101011010
01110101010131101111
00110101110010101010
01111001011111101010
01000111000001011110
01111001131111110110
00101000010100000110
00611111111411111110
00000000000000000000